Line n 1 : ﻿الحمد لله اكبر منظبط حزبيا ، و اول مرة اقدم موقفي في شئيا ما ...شخصيا اول مرة اعطي رائي في رجالات الدولة كنت ضد هذا التعيين تحيا تونس	Language : Tunisian ; 	Sentiment : Neutre
Line n 2 : quoi c'est une propagande pour camoufler la réalité de la vie. vous n'etes vraiment pas de bon citoyens. arretez vos mensonges , ce n'est pas dans l'interet du pays et de vos enfants.	Language : Other ; 	Sentiment : Unknown
Line n 3 : el éhtimem bi siyaset wa masar el é9tisadi wel éjtima3i méhwar ma3hed  amériki ma3 thola min 9iyedet nida tounes	Language : Other ; 	Sentiment : Unknown
Line n 4 : وهل من أرقام أو إحصائيات جديده؟	Language : Other ; 	Sentiment : Positive
Line n 5 : اقتراح لمقاومة تسيب الاسعاروجشع التجار اقترح بالنسبة للمواد غير المدعمة  والخاضعة لمبدأ الأشعار أن يتولى المنتجين بعد احتساب نسب أرباح تجار الجملة والتفصيل التنصيص فوق أدوات التعليب على الثمن الأقصى المقترح للبيع وهكذا يمكن للمواطن أن يحمي نفسه بنفسه دون حاجة لهياكل المراقبة التي أظهرت تهرءها	Language : Arabic ; 	Sentiment : Neutre
Line n 6 : من هم الأحزاب	Language : Tunisian ; 	Sentiment : Neutre
Line n 7 : حافظ فقط حضر وبقية من الموالين فقط له كان على الطبوبي فهو يمثل الاتحاد على الورق فقط ، والأيام بيننا ،	Language : Arabic ; 	Sentiment : Positive
Line n 8 : حزب الاخوان مثل السوس ينخر في الدولة وفي حزبكم بدون ضجيج ، لكن سيأتي يوم وستعاقبون على التوافق المنافق الذي صار بينكما ،	Language : Arabic ; 	Sentiment : Negative
Line n 9 : اين بقية الاحزاب الاخرى ؛	Language : Arabic ; 	Sentiment : Neutre
Line n 10 : اين الحراك الشعبي	Language : Tunisian ; 	Sentiment : Neutre
Line n 11 : اين افاق تونس	Language : Tunisian ; 	Sentiment : Neutre
Line n 12 : اين حزب الجمهوري	Language : Tunisian ; 	Sentiment : Negative
Line n 13 : اياد الدهماني ذالك الانتهازي باع اهله وباع القضية والتف حولكم من اجل مصلحته ليس الا	Language : Tunisian ; 	Sentiment : Negative
Line n 14 : عندي تاريخو وفيديوهاتو التي كان يشتم فيكم وفي حزب الاخوان والغنوشي الذي صرح ذات يوم وقال داعش هم مسلمون في حالة غضب	Language : Tunisian ; 	Sentiment : Negative
Line n 15 : راشد الغنوشي احداث باب سويقة	Language : Tunisian ; 	Sentiment : Neutre
Line n 16 : راشد الغنوشي الي وصرح انو الدواعش يفكروه بصغره	Language : Tunisian ; 	Sentiment : Neutre
Line n 17 : اما بعد فتحية الى قلة قلائل من الحزب "نداء تونس وخاصة القدامى والذي تم تنحيتهم بدون موجب فقط انهم لم يؤدوا الولاء لصاحب البتيندة"	Language : Arabic ; 	Sentiment : Negative
Line n 18 : حسبي الله و نعم الوكيل	Language : Tunisian ; 	Sentiment : Neutre
Line n 19 : 6 متخرجين و الكل معطلين عن العمل علاش!!!	Language : Tunisian ; 	Sentiment : Negative
Line n 20 :  خاطر ماناش متحزبين ما عناش أكتاف	Language : Tunisian ; 	Sentiment : Neutre
Line n 21 : تحيا الثورة ثورة الشغل و الكرامة	Language : Tunisian ; 	Sentiment : Neutre
Line n 22 : بربي رانى فديتت من 2004 وانا متخرجة وعاطلة على العمل ولى 3 اطفال وزوجي بطال  القولى حل	Language : Arabic ; 	Sentiment : Neutre
Line n 23 : Rabi ysahelek	Language : Other ; 	Sentiment : Unknown
Line n 24 : Ma3adech barcha w na9rou lfet7a mel far7a	Language : Other ; 	Sentiment : Unknown
Line n 25 : Alahoma barek fi omrou	Language : Other ; 	Sentiment : Unknown
Line n 26 : Allah yahlekom	Language : Other ; 	Sentiment : Unknown
Line n 27 : بالتوفيق	Language : Tunisian ; 	Sentiment : Neutre
Line n 28 : je suis fils d'un bourguibiste patriote ,je veux payer mes impôts ,pour avoir un permis de construction ,et je suis propriétaire de c terrain ,situation en regle, une bande de voyou de enahdha  m'empêche de payer mes impôt ,encore je suis pour NIDAA TOUNES , SOS J'ATTEND VOTRE REPONSE MO NUMERO DE TEL 93 476 021 .MERCI MES FRERES NIDAA TOUNES.	Language : Other ; 	Sentiment : Unknown
Line n 29 : الخبير محسن حسن يقنع في كل مداخلاته ، متمكن في تحاليله ، واقعي في تفكيره ، هو كسيف ساموري ، لا يخجل في قول الحقيقة كاملة ،	Language : Tunisian ; 	Sentiment : Positive
Line n 30 : Tawa wa3tou y'a si hafedh un homme d'affaire de plus...	Language : Other ; 	Sentiment : Unknown
Line n 31 : لا تلفون يخدم ولا الواحد ينجم يتصل بيكم كيفاش تتعاملو مع الماطن	Language : Tunisian ; 	Sentiment : Neutre
Line n 32 : بالتوفيق سي محي الدين	Language : Tunisian ; 	Sentiment : Neutre
Line n 33 : 😡😡😡😡😡😡😡	Language : Arabic ; 	Sentiment : Neutre
Line n 34 : Jabou Ahmed	Language : Other ; 	Sentiment : Unknown
Line n 35 : دعوة الحكومة !!	Language : Tunisian ; 	Sentiment : Neutre
Line n 36 : ياخي مش حكومتكم ؟!	Language : Tunisian ; 	Sentiment : Negative
Line n 37 : جبناء وما عندكم حتى احساس بتحمل المسؤولية.	Language : Arabic ; 	Sentiment : Positive
Line n 38 : هذا ليس وقت سياسة مسك العصى من الوسط.. المفروض مواقف جريئة تنحاز لتونس و تقطع يد من يحاول تخريبها مهما كان فلا مجال اليوم للحسابات	Language : Tunisian ; 	Sentiment : Neutre
Line n 39 : Allah la traba7kom	Language : Other ; 	Sentiment : Unknown
Line n 40 : ربي معكم	Language : Tunisian ; 	Sentiment : Neutre
Line n 41 : Tahiatunis wawaskot rc	Language : Other ; 	Sentiment : Unknown
Line n 42 : Berrasmi	Language : Other ; 	Sentiment : Unknown
Line n 43 : ههه الميركادو الشتوي لجمعية نداء تونس فقط لماذا يتم استقطاب رجال الاعمال ههه حزب العمايل	Language : Tunisian ; 	Sentiment : Neutre
Line n 44 : فاسد آخر؟ تبييض وغسيل أموال وتهرب جبائي؟ و كي يجد الجد يرموك كالكلب وما يتلفتولكشي!!	Language : Tunisian ; 	Sentiment : Negative
Line n 45 : أظن انه لن يفرح كثيرا بانتمائة لنداء تونس الذاهب الى الزوال	Language : Arabic ; 	Sentiment : Neutre
Line n 46 : ياخي عايشين معانا انتوما ! فايقين اش صاير في البلاد !	Language : Tunisian ; 	Sentiment : Negative
Line n 47 : الاندثار	Language : Arabic ; 	Sentiment : Neutre
Line n 48 : On s'en fout !!	Language : Other ; 	Sentiment : Unknown
Line n 49 : ما ينفعش	Language : Arabic ; 	Sentiment : Neutre
Line n 50 : Cha3eb fine  wentouma fines	Language : Other ; 	Sentiment : Unknown
Line n 51 : نحن جاهزون	Language : Tunisian ; 	Sentiment : Neutre
Line n 52 : بتوفيق	Language : Tunisian ; 	Sentiment : Neutre
Line n 53 : Fathi Gannoudi	Language : Other ; 	Sentiment : Unknown
Line n 54 : J'aimerais rentré aussi est faire avancée les choses dans le calme et l'organisation j'attends qu'on l'invite inchalah	Language : Other ; 	Sentiment : Unknown
Line n 55 : ندوة يغيب عنها الشباب؟	Language : Arabic ; 	Sentiment : Neutre
Line n 56 : يا ولدي ريظ احنا الشباب فيق	Language : Tunisian ; 	Sentiment : Negative
Line n 57 : Pour réussir il faut des jeunes	Language : Other ; 	Sentiment : Unknown
Line n 58 : avec les propres on peut gagner l enjeu	Language : Other ; 	Sentiment : Unknown
Line n 59 : تونس في القلب نداء الى رئيس الحكومة. خاطب الشعب في القنوات وطمنهم وادفع رجال الاعمال الى بعث المشاريع في المناطق الداخلية والحدودية العمل ثم العمل ومساعدت اصحاب الشهائد قبل كل شئ ووقف من الزيادات في الاجور	Language : Arabic ; 	Sentiment : Neutre
Line n 60 : يا عنربكم وربكم جميما كلاب وقرة وعنربكم مرة والاف المرات, والله بنكوكم أنتم وخلفاءكم عصابة مجرمة مع أطراف اجنبية,	Language : Tunisian ; 	Sentiment : Negative
Line n 61 : حافظ قايد السيسي ههه نترك ههه	Language : Tunisian ; 	Sentiment : Neutre
Line n 62 : لمن تقرا زابورك يا داوود	Language : Tunisian ; 	Sentiment : Neutre
Line n 63 : البطال اعاني من ازمة التنقل والبحث عن عمل انسان بطال كفاش يعمل	Language : Tunisian ; 	Sentiment : Negative
Line n 64 : كنابن من شئت واكتسب أدباً	Language : Arabic ; 	Sentiment : Neutre
Line n 65 : 	Language : Arabic ; 	Sentiment : Neutre
Line n 66 : يغنيك محموده عن النسب	Language : Arabic ; 	Sentiment : Neutre
Line n 67 : 	Language : Arabic ; 	Sentiment : Neutre
Line n 68 : إنالفتى من يقول هاأنذا	Language : Arabic ; 	Sentiment : Negative
Line n 69 : 	Language : Arabic ; 	Sentiment : Neutre
Line n 70 : ليس الفتى من يقول كان أبي	Language : Arabic ; 	Sentiment : Negative
Line n 71 : البهامة ما عندها حد!	Language : Tunisian ; 	Sentiment : Neutre
Line n 72 : Mala manadhir. Na3lbouk wbou il beji bouk. Chleyik	Language : Other ; 	Sentiment : Unknown
Line n 73 : Comique...pathétique...!!!	Language : Other ; 	Sentiment : Unknown
Line n 74 : جيناكم من جناب الله ﻻ توريونا تصويرة ce débile	Language : Tunisian ; 	Sentiment : Neutre
Line n 75 : Tahya touness bravo	Language : Other ; 	Sentiment : Unknown
Line n 76 : هذاالشبل من ذالك الاسد. منور يا حافظ. ان شاء الله حفظوك درسك	Language : Tunisian ; 	Sentiment : Positive
Line n 77 : Einstein light box can be replaced by the dimension N simulate by a line!	Language : Other ; 	Sentiment : Unknown
Line n 78 : الشعب لكم بالمرصاد يا عصبة اسراڨ	Language : Tunisian ; 	Sentiment : Negative
Line n 79 : يعطيه في الاوامر هههههه	Language : Tunisian ; 	Sentiment : Neutre
Line n 80 : Il y a une contradiction  chez nidaa . La coalition avec l arabie contre le terrorisme mais qui est en meme temps sioniste  .	Language : Other ; 	Sentiment : Unknown
Line n 81 : 	Language : Arabic ; 	Sentiment : Neutre
Line n 82 : كلّ المجتمع يأكل في لحم بعضعه البعض. الكلّ ينقد في الكلّ   لا الرّئيس سلم منهم و لا الحكومه ولا المعارضون ولا المجتمع المدني سلموا منهم و لا أحدهم راض عن الآخر و كلّهم يملكون الحقيقة و بيدهم عصى موسى للايجاد حلول للخروج ببلادنا الى برّ الأمان و هم على الرّبوة ينتظرون خراب بلادهم ليبنوها من جديد على مقاسهم و مصالحهم . رجاءا يا من تحبّون بلادكم بصدق اتركوا أهل الحكم يعملون و شاركوهم بأرائكم البنّائة لا بانتقاداتكم السّلبيّة لأجل المشاركة في الرّأي العام فقط . فبلادنا محتاجة الى كلّ فرد من شعبها للبناء و التّعمير بنظرة ايجابيّة محفوفة بالأمل لا باليأس و القنوط . و دمتم أحبّتي لتونس درعا لها و صونا لكرامتها و عزّا و شرفا لها .	Language : Tunisian ; 	Sentiment : Negative
Line n 83 : هل وزير مثل رياض الموخر تشد بفساد ب40مليون وما خفي كان اعظم ثم اعطى لاصلاح حديقة البلفيدار 65مليار من المليمات وللاسف مازال وزير الى اليوم هل بهذه الحكومة تونس باش تتقدم	Language : Tunisian ; 	Sentiment : Positive
Line n 84 : توا هذا كلام يا جماعه ياخي مزش انتم الحزب الحاكم	Language : Tunisian ; 	Sentiment : Negative
Line n 85 : من انتم ؟ لا شاءن لكم في وطني	Language : Tunisian ; 	Sentiment : Neutre
Line n 86 : وينو  الشعب  وين  هزيتوه  وين  ودرتوه	Language : Tunisian ; 	Sentiment : Negative
Line n 87 : .	Language : Arabic ; 	Sentiment : Neutre
Line n 88 : Attention  min  himayat. L  hamajia	Language : Other ; 	Sentiment : Unknown
Line n 89 : هل وزير مثل رياض الموخر تشد بفساد ب40مليون وما خفي كان اعظم ثم اعطى لاصلاح حديقة البلفيدار 65مليار من المليمات وللاسف مازال وزير الى اليوم هل بهذه الحكومة تونس باش تتقدم	Language : Tunisian ; 	Sentiment : Positive
Line n 90 : ما تنساوش:	Language : Tunisian ; 	Sentiment : Neutre
Line n 91 : *تركيا يحكمو فيها الخوانجية	Language : Tunisian ; 	Sentiment : Neutre
Line n 92 : *يا غنوشي يا سفاح	Language : Tunisian ; 	Sentiment : Neutre
Line n 93 : *لا تركيا لا قطر شعب تونس شعب حر	Language : Tunisian ; 	Sentiment : Negative
Line n 94 : لا عهد لا ميثاق.لعبتو بالمغفلين كيما حبيتو ودقت ساعة الحقيقة	Language : Tunisian ; 	Sentiment : Negative
Line n 95 : هل سأله لماذا يسمحون بدخول الإرهابيين من كل دول العالم الى سوريا؟	Language : Arabic ; 	Sentiment : Positive
Line n 96 : النداء إنتهى و إنتهى..	Language : Arabic ; 	Sentiment : Neutre
Line n 97 : و سمير لعبيدي معروف عند الجميع بأنو إنسان مسخ و موش جديد علينا.	Language : Tunisian ; 	Sentiment : Negative
Line n 98 : تبا لكم و لسياستكم القذرة..	Language : Tunisian ; 	Sentiment : Negative
Line n 99 : زيد عاد :كان يساري وقيادي في اتحاد طلبة تونس،قلب الفيستة وشراه بن علي وخدم بيه لسنوات.	Language : Tunisian ; 	Sentiment : Negative
Line n 100 : MABROUK KHOUYA SAMIR. BITTAWFIK INCHALLH. UN RENFORT DE TAILLE. JE SAIS DE QUOI JE PARLE.	Language : Other ; 	Sentiment : Unknown
Line n 101 : أنصح القيادة المركزية الاتصال والاعتنائ بقواعدها قبل الاتصال والاعتنائ بالكرايزن. هايتن. لأن القواعد هي. التي تأتي بالانتصارات وهي التي تتصل بأولاد الحومة ومتساكني الحومة والأصحاب والأحباب والجيران والاصهار. الئ حد هذه الساعة لم يقع الاتصال بالقواعد وبقيتم تستقطبون إلا في الكوادر العليا وفي المحامين والوزراء القدامئ سمير أو أمثاله مرحبا به. أما راهو ما ينجمش مثلا. يتصل وياطر أهالي سيدي حسين. وذكرت سيدي حسين لأنني من متساكنيها وهي من أكبر المعتمديات بالجمهورية التونسية من حيث العدد السكاني. .	Language : Arabic ; 	Sentiment : Neutre
Line n 102 : ان شاء الله مبروك علينا مرحبا بيه داخل النداء النداء مفتوح على الجميع	Language : Tunisian ; 	Sentiment : Neutre
Line n 103 : Ferchichi Karim chbik tikhdim min bikri wassa3 belik taw i3aytoulik ihotouk 3omda hhhhhhhjhhhhhhhhhhhhhhhhhhh	Language : Other ; 	Sentiment : Unknown
Line n 104 : Rabi yahfadh Tounes m'en kol makrouh !	Language : Other ; 	Sentiment : Unknown
Line n 105 : وبش كيفو كيف السبسي الصغير	Language : Tunisian ; 	Sentiment : Negative
Line n 106 : ههههه كملوا رجعوا بن علي وليلى	Language : Tunisian ; 	Sentiment : Neutre
Line n 107 : Brabi  wino  ezin  mazel  nakiskom	Language : Other ; 	Sentiment : Unknown
Line n 108 : ربي يحبب القلوب في بعضيها	Language : Tunisian ; 	Sentiment : Neutre
Line n 109 : 	Language : Arabic ; 	Sentiment : Neutre
Line n 110 : كونوا كيما خلق ربي الكل واعملوا مؤتمر .حزب يحكم بلا مؤتمر فضيحة بجلاجل	Language : Tunisian ; 	Sentiment : Negative
Line n 111 : Si vous arrivez à récupérer Mme Bochra Bel Haj Hmida vous pouvez sauver Nida Touness	Language : Other ; 	Sentiment : Unknown
Line n 112 : Tounis jamhouria mouch  moulokia	Language : Other ; 	Sentiment : Unknown
Line n 113 : ظاهر 2012,  بجاه ربي عالاش التبرير ماو من لول ثبتوا  اعرفو اشكون تجيبوا مش واحد ما يهضموا حد. عزاءكم في عبد الجليل سالم راجل صنعتو لقديمه كلامجي علم كلام في الزيتونه جيبوه يتكلم ثماش ميضويش الطف وانتم الله يسترنا من فضيحة لفضيحه	Language : Tunisian ; 	Sentiment : Negative
Line n 114 : السيد حافظ قايد السبسي، أود الاتصال بسيادتكم بخصوص الدفاع عن المستهلك وذلك في ضوء المقال الصادر أخيرا حول "قفة المستهلك" وفي هذا السياق، أشير إلى أني من مؤسسي منظمة الدفاع عن المستهلك التي يعود تأسيسها إلى أواخر الثمانينات كما أني مؤسس الحزب الجمهوري للحرية والعدالة( في مفهوم الانصاف) والذي توقف عن النشاط منذ مدة لافتقاره إلى الإمكانات المالية، مع التحية والتقدير، البشير فتح الله موظف متقاعد منذ سنة 2004 رئيس بلدية هرقلة سابقا ورئيس جمعية صيانة مدينة هرقلة وحماية المحيط حاليا	Language : Arabic ; 	Sentiment : Neutre
Line n 115 : السيد حافظ قايد السبسي، تحياتي، أود الاتصال بسيادتكم بخصوص الدفاع عن المستهلك في ضوء المقال الصادر أخيرا حول "قفة المستهلك" البشير فتحا لله	Language : Arabic ; 	Sentiment : Positive
Line n 116 : هذا البيان الهزيل الدليل القطعي علي ما ال له النداء من انحطات و فراغ ..ما القيتو اش كون تحطو	Language : Tunisian ; 	Sentiment : Neutre
Line n 117 : Vente et réparation et l'installation de PARABOLE TéL / 54644350 / 21271881 IBN KHALDOUN Le stations de métro 3	Language : Other ; 	Sentiment : Unknown
Line n 118 : السيد حافظ قايد السبسي، أود الاتصال بسيادتكم على هامش المقال الصادر حول قفة المواطن، لعله توفر سانحة على مسألة حماية المستهلك والدفاع على حقوقه، في الظروف الراهنة، علما وأني من مؤسسي منظمة الدفاع عن المستهلك وهي قادرة على أن تكون رافدا من أهم روافد حزب النداء إذا ما توفرت لها الامكانات المادية وكنت قد راسلت السيد رئيس الجمهورية في هذا الغرض منذ مقابلته مع السيد رئيس المنظمة الحالي الذيقدم للسيد رئيس الجمهورية، حسب المعلومات المتوفرة، بيانات خاطئة حول الوضع الذي تمر به المنظمة والذي يشبه الموت السريري والسلأأم	Language : Arabic ; 	Sentiment : Positive
Line n 119 : Vente et réparation et l'installation de PARABOLE TéL / 54644350 / 21271881 IBN KHALDOUN Le stations de métro 3	Language : Other ; 	Sentiment : Unknown
Line n 120 : تـحية مملوؤه  بـ التقدير والإحترام.. ومودة تحية محبة واحترام إلى سيدي خالد شوكات <3	Language : Tunisian ; 	Sentiment : Neutre
Line n 121 : Vente et réparation et l'installation de PARABOLE TéL / 54644350 / 21271881 IBN KHALDOUN Le stations de métro 3	Language : Other ; 	Sentiment : Unknown
Line n 122 : Vente et réparation et l'installation de PARABOLE TéL / 54644350 / 21271881 IBN KHALDOUN Le stations de métro 3	Language : Other ; 	Sentiment : Unknown
Line n 123 : Marzou9I	Language : Other ; 	Sentiment : Unknown
Line n 124 : النداء مزال قوي رغم مشاكله. ...	Language : Tunisian ; 	Sentiment : Neutre
Line n 125 : Vente et réparation et l'installation de PARABOLE TéL / 54644350 / 21271881 IBN KHALDOUN Le stations de métro 3	Language : Other ; 	Sentiment : Unknown
Line n 126 : تحيا تونس ✌️🇹🇳	Language : Tunisian ; 	Sentiment : Neutre
Line n 127 : Vente et réparation et l'installation de PARABOLE TéL / 54644350 / 21271881 IBN KHALDOUN Le stations de métro 3	Language : Other ; 	Sentiment : Unknown
Line n 128 : Vente et réparation et l'installation de PARABOLE TéL / 54644350 / 21271881 IBN KHALDOUN Le stations de métro 3	Language : Other ; 	Sentiment : Unknown
Line n 129 : الله يرحم الزعيم و المجاهد الاكبر	Language : Tunisian ; 	Sentiment : Positive
Line n 130 : Vente et réparation et l'installation de PARABOLE TéL / 54644350 / 21271881 IBN KHALDOUN Le stations de métro 3	Language : Other ; 	Sentiment : Unknown
Line n 131 : Bravo bravo	Language : Other ; 	Sentiment : Unknown
Line n 132 : تخيلوا المنصف المرزوقي وهو رئيس عمل مطار واذاعة في قبلي و رجعها ولاية بعد ما كانت معتمدية و حط مليارات في قبلي و بقية المناطق طفاها و سمى كل الشوارع الرئيسية في كل مدينة تونسية باسمه و عمل تماثيل لنفسه في كل مدينة و حط جماعة قبلي و دوز في كل الوزارات و منح الرخص و الآفاريات لأنسابه من قرمبالية و كل صيف يحتفل بعيد ميلاده و يصرف المليارات من رزق البيليك و بعد عامين من حكمه يغتال نجيب الشابي و يحط علي العريض وحمة الهمامي في الحبس و أي واحد يعارضه ينكّل بيه و ينصب محاكمات سياسية تقضي بإعدام معارضيه و يسيب البوليس يعذب و يقتل و يضرب بالرصاص مسيرات للنقابيين و يعلن نفسه رئيس مدى الحياة و يمنع الإنتخابات و يجيب بنت أخته تحكم في القصر و تجيب في البنات الصغار بش سي المنصف يفاحشهم.... حتى لين سي المنصف يكبر و يخرف و يردنا ضحكة بين الشعوب و يولي قصر قرطاج قصر دعارة و طوال 30 عام من حكمه إقتصاد بارك و الفقر كل عام يزيد و نصف الشعب بلا ماء ولا كهرباء و يبدا يبني في قصر 5 نجوم و برخام ايطاليا ليكون مقبرة لحضرة جنابه.. و زيد فوق ذلك يحطلنا وزير أول مجرم من المقربين منه يعمل عليه إنقلاب و بعد ما عدينا 30 عام عذاب من حكم المرزوقي يجينا كلبه ليسومنا عذاب آخر طيلة 23 عام..... تخيلوا هالمنصف المرزوقي هذا مات في مثل هذا اليوم.	Language : Tunisian ; 	Sentiment : Negative
Line n 133 : هل يمكن لعقل سوي و لتونسي يحب تونس أن يترحم عليه؟	Language : Tunisian ; 	Sentiment : Neutre
Line n 134 : هل يمكن لتونسي محترم وسوي نفسيّا يقلك "المرزوقي قرّاك و نحالك القمل"؟	Language : Tunisian ; 	Sentiment : Positive
Line n 135 : برا لا ترحملك عظم يا" منصف مرزوقي"	Language : Tunisian ; 	Sentiment : Neutre
Line n 136 : و الله طمنتونا ما دام عملتو اجتماع قمقوم ناقشتو فيه زيارة سي الباجي للمستير بارك الله فيكم محلاكم.	Language : Tunisian ; 	Sentiment : Positive
Line n 137 : Chaib jaïn ones chaiyra ttmanyk ala mouwtn zaAli moltakana  fi 2019 inchalla	Language : Other ; 	Sentiment : Unknown
Line n 138 : Vente et réparation et l'installation de PARABOLE TéL / 54644350 / 21271881 IBN KHALDOUN Le stations de métro 3	Language : Other ; 	Sentiment : Unknown
Line n 139 : اين  نحن  منكم  وكيف  الرجوع  اليكم  وانتم  من  خذلتونا  وورطونا في  تحالف  شيطاني  ادى  بتونسنا  الي  حافة  الانهيار	Language : Tunisian ; 	Sentiment : Neutre
Line n 140 : ما  هي  براهينكم  الجديدة  وما الذي فعلناه  في  اوعودكم  الماضية  نحن  فيءة  من  الشعب  نعطي  فرصة  وانما  لا  نعيدها  لاننا  مجروحين  ولستم  بالدواء  المناسب	Language : Tunisian ; 	Sentiment : Neutre
Line n 141 : Vente et réparation et l'installation de PARABOLE TéL / 54644350 / 21271881 IBN KHALDOUN Le stations de métro 3	Language : Other ; 	Sentiment : Unknown
Line n 142 : الى السيدة بشرى بالحاج حميجة : الرجاء كل الرجاء البحث وراء الاسالب الني اثرت سلبا على سير قضية وفاة زوجتي ضد بعض اطباء مستشفى بنزرت المنشورة لدى التحقيق تحت عدد 28331 منذ جانفي 2012 وتم فبرها ، لابقى انا العجوز الجريح اتجرع مرارة الفراق على زوجتي واتجرع مرارة الاحتفار والاستخفاف بحقوق الزواولة خاصة وانا زوج الضحية مجرد عجوز كاتب محامي تقاعدت مؤخرا والطرف المقابل اطباء لهم حصانة خاصة ـ حسبي الله ونعم الوكيل .	Language : Arabic ; 	Sentiment : Neutre
Line n 143 : bien dit <3	Language : Other ; 	Sentiment : Unknown
Line n 144 : اخيرا اصبح لتونس رىيس	Language : Tunisian ; 	Sentiment : Neutre
Line n 145 : شكرا لكل من انتخبك	Language : Arabic ; 	Sentiment : Neutre
Line n 146 : ستعيش رغم الداء والاعداء	Language : Arabic ; 	Sentiment : Neutre
Line n 147 : كالنسر فوق القمة الشماء	Language : Arabic ; 	Sentiment : Neutre
Line n 148 : كان الله في عونك	Language : Tunisian ; 	Sentiment : Neutre
Line n 149 : bravo bajbouj	Language : Other ; 	Sentiment : Unknown
Line n 150 : klemik shih	Language : Other ; 	Sentiment : Unknown
Line n 151 : wa7dek ya m3alem  <3	Language : Other ; 	Sentiment : Unknown
Line n 152 : wahdik yalbouj	Language : Other ; 	Sentiment : Unknown
Line n 153 : رد  سيادة رئيس الجمهورية يعانق الروعة  لموضوعيته ...	Language : Tunisian ; 	Sentiment : Neutre
Line n 154 : Clair et net	Language : Other ; 	Sentiment : Unknown
Line n 155 : On a politisé les mosquées depuis qu'on a accordé le visa à un parti religieux.	Language : Other ; 	Sentiment : Unknown
Line n 156 : YAHYA LBAJBOUJ	Language : Other ; 	Sentiment : Unknown
Line n 157 : hhhhhhhhh ya mhabelhom tahya tuns	Language : Other ; 	Sentiment : Unknown
Line n 158 : <3	Language : Other ; 	Sentiment : Unknown
Line n 159 : Pour les islamistes, la séparation entre la politique (l'Etat) et la religion ne sera jamais à l'ordre du jour ! C'est un DOGME de l'islam ,sauf peut-être si monsieur McCaine s'en mêle...	Language : Other ; 	Sentiment : Unknown
Line n 160 : يا شعب افهم ما يعني قانون المصالحة من سيادة الرئيس	Language : Tunisian ; 	Sentiment : Negative
Line n 161 : ناقصين فهم صحيح وما يحبوش الخير لتونس ويقولو ديم لا للحكومة والرئيس حتى لو كان الكلام صحيح	Language : Tunisian ; 	Sentiment : Positive
Line n 162 : Bravoo s est ce que il faut faire ! Wallahi logique klamo ! Ti haw nehbo balad w halo des projets au Maroc !! 3aad on profite nous pas mieux !	Language : Other ; 	Sentiment : Unknown
Line n 163 : ;unplaisir d'entendre les arguments;bravoil est en superforme	Language : Other ; 	Sentiment : Unknown
Line n 164 : bravoooo	Language : Other ; 	Sentiment : Unknown
Line n 165 : Bravooooo Bajbouji	Language : Other ; 	Sentiment : Unknown
Line n 166 : Bravo rabi ykhaliik	Language : Other ; 	Sentiment : Unknown
Line n 167 : فبحيث يحيا البجبوج	Language : Arabic ; 	Sentiment : Neutre
Line n 168 : Bravo	Language : Other ; 	Sentiment : Unknown
Line n 169 : فبحيث يحيا البجبوج	Language : Arabic ; 	Sentiment : Neutre
Line n 170 : Ceux ont voté pour vous  savaient ce qu'il fallait faire pour sauver la Tunisie : après quelques mois je pense qu'ils sont beaucoup plus nombreux à aimer leur patrie grâce à vous	Language : Other ; 	Sentiment : Unknown
Line n 171 : Vive la Tunisie	Language : Other ; 	Sentiment : Unknown
Line n 172 : Vive Beji	Language : Other ; 	Sentiment : Unknown
Line n 173 : Bravo!	Language : Other ; 	Sentiment : Unknown
Line n 174 : Bravo Bajboujjjjjjjj	Language : Other ; 	Sentiment : Unknown
Line n 175 : ye3jééééééééééééééébni <3 <3 :D	Language : Other ; 	Sentiment : Unknown
Line n 176 : Il faut toujours faire un dessin pour comprendre malla peuple rabbi yahdi	Language : Other ; 	Sentiment : Unknown
Line n 177 : Bravo mr le président	Language : Other ; 	Sentiment : Unknown
Line n 178 : kalam sah	Language : Other ; 	Sentiment : Unknown
Line n 179 : Da Tounes sait bien faire les choses...	Language : Other ; 	Sentiment : Unknown
Line n 180 : Kol yom yzid yodkhol galbi yaatih houta	Language : Other ; 	Sentiment : Unknown
Line n 181 : شكرا لك	Language : Arabic ; 	Sentiment : Neutre
Line n 182 : Bravo	Language : Other ; 	Sentiment : Unknown
Line n 183 : Raw tham ebad ma tefhemch y3rfou kan tari9et ba9aron 9irdon	Language : Other ; 	Sentiment : Unknown
Line n 184 : fort alihoum, me yefhmouchi jme3et 0,00000000000000000000	Language : Other ; 	Sentiment : Unknown
Line n 185 : Allah yahfdhou.	Language : Other ; 	Sentiment : Unknown
Line n 186 : BRAVO  BAJBOUJ	Language : Other ; 	Sentiment : Unknown
Line n 187 : L'unique solution c'est d'entamer une reforme radicale de l'administration .	Language : Other ; 	Sentiment : Unknown
Line n 188 : bajbouj yei m3alem	Language : Other ; 	Sentiment : Unknown
Line n 189 : سي محسن حبذا لو تهتمولنا بوضع الزوالي و الفئات المهمشة ,المجلس التأسيسي يصادق على زيادته الخاصة و نسي أنه جاء لإصلاح حال البلاد و العباد و ليس لإصلاح حاله و حال أغنياء البلاد و أنا كإبن تونس و نداء تونس و أمين مال في تنسيقية محلية لحزب النداء أنادي و أطلب منك الإهتمام بالموضف و الزوالي و المتخرجين لأنهم هم زاد الإنتخابات و ما ألمسه لا ينبأ بالخير فالبلاد تغلي و أنتم غير عابئين و أنا مسؤوليتي أن أنبهكم لما فيه صالح حزبي و صالح بلادي و ديمومة النجاح الإنتخابي	Language : Tunisian ; 	Sentiment : Neutre
Line n 190 : سي مرزوق دعكم بالله من هؤلاء الأعراب فلا خير يُرجى منهم والتاريخ شاهد على افعالهم	Language : Tunisian ; 	Sentiment : Positive
Line n 191 : كونوا ايجابيين !	Language : Arabic ; 	Sentiment : Neutre
Line n 192 : لنحب الحياة وندعوا للامل وللوطن ..كفوا عن التذمر وللننظر برؤية ايجابية ولنعمل ..	Language : Tunisian ; 	Sentiment : Positive
Line n 193 : المانيا فاتت اغلب دول التحالف بعد تدميرها كليا من التحالف ...كونت قوة اقتصادية شان اليابان	Language : Arabic ; 	Sentiment : Neutre
Line n 194 : شعوب كانت ايجابية...	Language : Arabic ; 	Sentiment : Negative
Line n 195 : ابطال الجيش والحرس والامنيين الشرفاء باعوا حلم الذات لاجل الوطن ...	Language : Tunisian ; 	Sentiment : Neutre
Line n 196 : خوفي من الندم بضياع الوطن ..فاليوم غيرت داعش سياسة التعليم بسرت ونحن مازلنا نحتج على	Language : Arabic ; 	Sentiment : Neutre
Line n 197 : اسبوع مغلق وتنظيم العطل ...	Language : Arabic ; 	Sentiment : Neutre
Line n 198 : لم يبلغ احتجاج المعطلين احتجاج بعض المؤظفين.. اننا ضد الكثير من المسائل لكن ليكن نقدنا في اطار الدولة	Language : Arabic ; 	Sentiment : Negative
Line n 199 : ومؤسساتها وليس في اطار الخروج عن الدولة ولنضغط بكل وطنية ولتكن مسيراتنا منضبطة ولا مجال لخطابات هدامة لو نظمت ..لوتكن كتاباتنا بالفايسبوك وكاننا نقاوم عدوا على الحدود	Language : Arabic ; 	Sentiment : Neutre
Line n 200 : كونوا اوفياء فقط لتونس... التي تريد العمل والامل والمطالبة والنقد البناء لا الهدم بسبب مصالح بعضهم الضيقة لاعتلاء منصب او التنصل من محاكمات او ما شابه ذلك ...	Language : Arabic ; 	Sentiment : Neutre
Line n 201 : علي الاقل محسن مرزوق هوي ااوحيد ااذي يهتم بارجاع علاقة تونس مع كل اابلدان  طبعا الي جانب  زيارات اارئيس ااسيد ااباجي قايد ااسبسي	Language : Tunisian ; 	Sentiment : Positive
Line n 202 : محسن بيوش ولا راجل	Language : Tunisian ; 	Sentiment : Positive
Line n 203 : chokran  mohson alla ili majhoud wili 9a3id ta3tifih lil blalad	Language : Other ; 	Sentiment : Unknown
Line n 204 : Mr Marzouk priere de voir comment vous pouvez nous aider a retrouver nos trottoires pour les familles avec enfants ca pourrait nous etre utile plusque les entretiend avec les diplomates etc etc...Merci	Language : Other ; 	Sentiment : Unknown
Line n 205 : سي محسن شكراً لك على مجهودك في تحسين العلاقات الدبلوماسية	Language : Tunisian ; 	Sentiment : Positive
Line n 206 : نداء لأصحاب الشهائد العليا: بما أنو ولات فيها مصالح شخصية وكل شريحة من الخريجين تطالب بإدماجها في الشغل في وزارة التربية وهنا كل واحد تعطيه حقو في ذلك, على سبيل الذكر الأساتذة النواب مثلا وقدماء الإتحاد للطلبة وغيرو هنا آنا نفهم الي كل واحد يضرب على درابوه وماعادش فما إلتفاف حول المطلب الوحيد هو الشغل , ربي يعين الناس لكل, وبالتالي آنا نوجه نداء عاجل لشريحة معينة من الخريجي بمختلف الإختصاصات من رياضيات,علوم,فيزياء,كيمياء,تاريخ,حقوق,فرنسية,عربية الناس إلي تميزوا والي كانو مالأوائل الناس الي تحصلوا على معدل تخرج يفوق 12 ونعلمهم إلي وزارة الصحة وغيرها تنتدب في الكفاءات لي كيفكم الي قراو وتميزوا وجابو ملاحظات الحسن و قريب ملحسن نقلكم أنتوما اكفاءات وعندكم الأولوية في العمل    "  أنتوما  بضع المئات  الأوائل متاع الجامعات التونسية   "   إذن لازمنا نشكلو وحدة باش نفتكوا أماكنا الحقيقية لازمنا نتعرفو و نتقابلو وأتأكدو باش يكون عندنا صوت ثاقب ومسموع كل واحد يخلي نومروه ، كونوا متحمسين لسبب بسيط هو  " انكم  الأوائل من خيرة ما أنجبت الجامعات التونسية فستكونون الأوائل و المنتصرين "   97806585 كل واحد منكم يخلي نومروه	Language : Tunisian ; 	Sentiment : Negative
Line n 207 : أين الوعود التي وعدة بها مناضلين الحزب يا سيد محسن مرزوق .	Language : Tunisian ; 	Sentiment : Positive
Line n 208 : الله لاتربحك ياالعباسي هذا الكل من تحت راسك	Language : Tunisian ; 	Sentiment : Neutre
Line n 209 : أحسنت الرجل المناسب في المكان المناسب شكرا سير على بركة الله وجميع التونسيين معك	Language : Arabic ; 	Sentiment : Positive
Line n 210 : Braaavo	Language : Other ; 	Sentiment : Unknown
Line n 211 : persévérance et fermeté restent les mots clefs d'une bonne démarche politique ! merci monsieur le ministre de les avoir appliquer !	Language : Other ; 	Sentiment : Unknown
Line n 212 : RABBI  IKOUN  EMAH	Language : Other ; 	Sentiment : Unknown
Line n 213 : bravoo	Language : Other ; 	Sentiment : Unknown
Line n 214 : En avant ...	Language : Other ; 	Sentiment : Unknown
Line n 215 : يجب توقيفهم الذين قصوا الضوء  والتحقيق معهم عبرة لغيرهم	Language : Arabic ; 	Sentiment : Neutre
Line n 216 : bravo	Language : Other ; 	Sentiment : Unknown
Line n 217 : Bravo rabi maak	Language : Other ; 	Sentiment : Unknown
Line n 218 : BRAVOOOOO	Language : Other ; 	Sentiment : Unknown
Line n 219 : bravo Mr le Ministre tout mes respects	Language : Other ; 	Sentiment : Unknown
Line n 220 : bravo	Language : Other ; 	Sentiment : Unknown
Line n 221 : il faut nettoyer le hôpitaux des corrompus et des fainéants	Language : Other ; 	Sentiment : Unknown
Line n 222 : لكن مش صك على بياض يا سي العكرمي	Language : Tunisian ; 	Sentiment : Neutre
Line n 223 : قولو لسي اللومي يدبر على ر وحو ، وماعادش يخاطبنا بلغة .......... كذا باش يولي حزب حداثي .... قولولوا مبروك عليك انت و ابعدنا  يرحم بوك ....	Language : Tunisian ; 	Sentiment : Negative
Line n 224 : "الإخوان" خوّان وإلي حط أيديه في أيديهم يصير فيه اكثر من هكة.	Language : Tunisian ; 	Sentiment : Negative
Line n 225 : ممكن ملخص الملتقى	Language : Arabic ; 	Sentiment : Neutre
Line n 226 : يصراحة كنتم املنا لذلك وضعنا كل ثقتتنا فيكم وانتخبناكم....لكنكم خيبتم امالنا.....فقدنسيتم  كل وعودكم	Language : Tunisian ; 	Sentiment : Neutre
Line n 227 : نداء لأصحاب الشهائد العليا: بما أنو ولات فيها مصالح شخصية وكل شريحة من الخريجين تطالب بإدماجها في الشغل في وزارة التربية وهنا كل واحد تعطيه حقو في ذلك, على سبيل الذكر الأساتذة النواب مثلا وقدماء الإتحاد للطلبة وغيرو هنا آنا نفهم الي كل واحد يضرب على درابوه وماعادش فما إلتفاف حول المطلب الوحيد هو الشغل , ربي يعين الناس لكل, وبالتالي آنا نوجه نداء عاجل لشريحة معينة من الخريجي بمختلف الإختصاصات من رياضيات,علوم,فيزياء,كيمياء,تاريخ,حقوق,فرنسية,عربية الناس إلي تميزوا والي كانو مالأوائل الناس الي تحصلوا على معدل تخرج يفوق 12 ونعلمهم إلي وزارة الصحة وغيرها تنتدب في الكفاءات لي كيفكم الي قراو وتميزوا وجابو ملاحظات الحسن و قريب ملحسن نقلكم أنتوما اكفاءات وعندكم الأولوية في العمل    "  أنتوما  بضع المئات  الأوائل متاع الجامعات التونسية   "   إذن لازمنا نشكلو وحدة باش نفتكوا أماكنا الحقيقية لازمنا نتعرفو و نتقابلو وأتأكدو باش يكون عندنا صوت ثاقب ومسموع كل واحد يخلي نومروه ، كونوا متحمسين لسبب بسيط هو  " انكم  الأوائل من خيرة ما أنجبت الجامعات التونسية فستكونون الأوائل و المنتصرين "   97806585 كل واحد منكم يخلي نومروه	Language : Tunisian ; 	Sentiment : Negative
Line n 228 : و الله يعطيه الصحة البجبوج رغم البعد جاء وبصراحة ال مكتوم باهيين برشا و يستاهلوا الناس تواسيهم الله يرحموا و تكون آخر احزانهم	Language : Tunisian ; 	Sentiment : Negative
Line n 229 : اللهم ارحم كل من قال لا الاه الا الله محمد رسول الله	Language : Tunisian ; 	Sentiment : Negative
Line n 230 : لم نره يعزي أحدا من جنودنا أو أمنيينا و الذين سقطو ضحايا في حادث قطار الفحص لا تبعد كثيرا عن العاصمة  و الا سيادتو ما يضوي كان على البراني	Language : Arabic ; 	Sentiment : Neutre
Line n 231 : رحم الله ابن الشيخ زايد	Language : Tunisian ; 	Sentiment : Negative
Line n 232 : الله يرحم الشيخ راشد و يغفر له و يجعل مثواه الجنة يا رب	Language : Tunisian ; 	Sentiment : Positive
Line n 233 : المسافة بين تونس ودبي حوالي 4500 كلم وتستغرق الرحلة بالطائرة قرابة 6 ساعات ..	Language : Arabic ; 	Sentiment : Neutre
Line n 234 : بينما الفحص التي حصل فيها حادث القطار والذي أودى بحياة قرابة 17 مواطنا تونسيا ،.. لا تبعد أكثر من 55 كيلومتر ولا تحتاج إلا لنصف ساعة لكي يصل إليها موكب سيادة رئيس الجمهورية..	Language : Arabic ; 	Sentiment : Neutre
Line n 235 : رئيسهم لا يحضر جنازات أبناء الشعب البسطاء.. يحضر إلا جنازات الأثرياء والأمراء و الرؤساء حتى ولو كانت بعيدة آلاف الكيلومترات	Language : Arabic ; 	Sentiment : Neutre
Line n 236 : الله يرحم ويصبر اهل بصراحة عائلة ال مكتوم باهين خدم بلادهم	Language : Tunisian ; 	Sentiment : Neutre
Line n 237 : Allah yarhmou wina3mou 😞	Language : Other ; 	Sentiment : Unknown
Line n 238 : الله يرحمه ويعطيه الصحة الباجي	Language : Tunisian ; 	Sentiment : Neutre
Line n 239 : تحية لرئسنا👍وتعازينا للشيخ محمد بن راشد ..الله يرحمه	Language : Tunisian ; 	Sentiment : Positive
Line n 240 : allah yarhmou w si el beji yaatek essaha	Language : Other ; 	Sentiment : Unknown
Line n 241 : i hope bajbouj  will succeed in putting Emirates-Tunisian relations on a normal diplomatic footing. i do respect him.	Language : Other ; 	Sentiment : Unknown
Line n 242 : بجبوجنا اصيل و صاحب واجب	Language : Tunisian ; 	Sentiment : Positive
Line n 243 : تونس ستظل دائما تعرف الواجب والوقوف الى جانب اصدقائها في السراء والضراء	Language : Arabic ; 	Sentiment : Positive
Line n 244 : Encor un Historie tunisienno Araabboo!!?	Language : Other ; 	Sentiment : Unknown
Line n 245 : وأخيرا جاءنا رئيس يعرف الواجب...يمثل تونس....!؟	Language : Tunisian ; 	Sentiment : Neutre
Line n 246 : Bravooo bajbouj	Language : Other ; 	Sentiment : Unknown
Line n 247 : Bravo Mr le president	Language : Other ; 	Sentiment : Unknown
Line n 248 : Always at the right time	Language : Other ; 	Sentiment : Unknown
Line n 249 : Allah yarhmou	Language : Other ; 	Sentiment : Unknown
Line n 250 : Bravo	Language : Other ; 	Sentiment : Unknown
Line n 251 : الله يرحمو و ينعمو	Language : Tunisian ; 	Sentiment : Neutre
Line n 252 : Allahyarhmou ....si jeune...	Language : Other ; 	Sentiment : Unknown
Line n 253 : http://nawaat.org/portail/2014/11/19/essebsichiboub-retour-sur-une-affaire-aux-arcanes-troublantes/	Language : Arabic ; 	Sentiment : Neutre
Line n 254 : Chaddlou yeddou ma sayeb! Za3ma fin hezzou?	Language : Other ; 	Sentiment : Unknown
Line n 255 : لله يرحمو و ينعمو	Language : Tunisian ; 	Sentiment : Neutre
Line n 256 : ممكن ملخص الملتقى	Language : Arabic ; 	Sentiment : Neutre
Line n 257 : يصراحة كنتم املنا لذلك وضعنا كل ثقتتنا فيكم وانتخبناكم....لكنكم خيبتم امالنا.....فقدنسيتم  كل وعودكم	Language : Tunisian ; 	Sentiment : Neutre
Line n 258 : نداء لأصحاب الشهائد العليا: بما أنو ولات فيها مصالح شخصية وكل شريحة من الخريجين تطالب بإدماجها في الشغل في وزارة التربية وهنا كل واحد تعطيه حقو في ذلك, على سبيل الذكر الأساتذة النواب مثلا وقدماء الإتحاد للطلبة وغيرو هنا آنا نفهم الي كل واحد يضرب على درابوه وماعادش فما إلتفاف حول المطلب الوحيد هو الشغل , ربي يعين الناس لكل, وبالتالي آنا نوجه نداء عاجل لشريحة معينة من الخريجي بمختلف الإختصاصات من رياضيات,علوم,فيزياء,كيمياء,تاريخ,حقوق,فرنسية,عربية الناس إلي تميزوا والي كانو مالأوائل الناس الي تحصلوا على معدل تخرج يفوق 12 ونعلمهم إلي وزارة الصحة وغيرها تنتدب في الكفاءات لي كيفكم الي قراو وتميزوا وجابو ملاحظات الحسن و قريب ملحسن نقلكم أنتوما اكفاءات وعندكم الأولوية في العمل    "  أنتوما  بضع المئات  الأوائل متاع الجامعات التونسية   "   إذن لازمنا نشكلو وحدة باش نفتكوا أماكنا الحقيقية لازمنا نتعرفو و نتقابلو وأتأكدو باش يكون عندنا صوت ثاقب ومسموع كل واحد يخلي نومروه ، كونوا متحمسين لسبب بسيط هو  " انكم  الأوائل من خيرة ما أنجبت الجامعات التونسية فستكونون الأوائل و المنتصرين "   97806585 كل واحد منكم يخلي نومروه	Language : Tunisian ; 	Sentiment : Negative
Line n 259 : نداء لأصحاب الشهائد العليا: بما أنو ولات فيها مصالح شخصية وكل شريحة من الخريجين تطالب بإدماجها في الشغل في وزارة التربية وهنا كل واحد تعطيه حقو في ذلك, على سبيل الذكر الأساتذة النواب مثلا وقدماء الإتحاد للطلبة وغيرو هنا آنا نفهم الي كل واحد يضرب على درابوه وماعادش فما إلتفاف حول المطلب الوحيد هو الشغل , ربي يعين الناس لكل, وبالتالي آنا نوجه نداء عاجل لشريحة معينة من الخريجي بمختلف الإختصاصات من رياضيات,علوم,فيزياء,كيمياء,تاريخ,حقوق,فرنسية,عربية الناس إلي تميزوا والي كانو مالأوائل الناس الي تحصلوا على معدل تخرج يفوق 12 ونعلمهم إلي وزارة الصحة وغيرها تنتدب في الكفاءات لي كيفكم الي قراو وتميزوا وجابو ملاحظات الحسن و قريب ملحسن نقلكم أنتوما اكفاءات وعندكم الأولوية في العمل    "  أنتوما  بضع المئات  الأوائل متاع الجامعات التونسية   "   إذن لازمنا نشكلو وحدة باش نفتكوا أماكنا الحقيقية لازمنا نتعرفو و نتقابلو وأتأكدو باش يكون عندنا صوت ثاقب ومسموع كل واحد يخلي نومروه ، كونوا متحمسين لسبب بسيط هو  " انكم  الأوائل من خيرة ما أنجبت الجامعات التونسية فستكونون الأوائل و المنتصرين "   97806585 كل واحد منكم يخلي نومروه	Language : Tunisian ; 	Sentiment : Negative
Line n 260 : wini.taswiret.essbsiiiiiiiiiiiiiiiiiiiiiiiiiiiiiiiiiiiiiiiiiiiiiiiiiiiiiiiiiiiiiiiiii.rais.el.jmhuria	Language : Other ; 	Sentiment : Unknown
Line n 261 : لا نجاح لأي مشروع اصلاحي اذا ما تم التراجع  عما يتخذ من قرارات. التنازلات الصغيرة تؤدي حتما للتنازلات الكبيرة. عندها وداعا للإصلاحات جملة وتفصيلا. انت، سيدي الوزير ووزير التربية سوف تقرران، إن تمسكتما بمواقفكما الشجاعة في معالجة قضايا الصحة والتعليم، قرب خروج بلادنا من قمقم الهمجية والفوضى الذي تردت فيه بفعل بهامة النقابات وخبث الاخوان.	Language : Arabic ; 	Sentiment : Positive
Line n 262 : ما بقا كان نعين النقاببين علي راس الوزارات لا حلو. علي الحكومة معاقبة من لا يحترم القانون مهما كانت صيفتو و الا باش يصير كيما صار في الحوض المنجمي. اين هي الدولة؟	Language : Tunisian ; 	Sentiment : Negative
Line n 263 : سيدي الوزير اذاتراجعتم.  تلك هي المصيبة...لا بد من القضاء على أعداء الإصلاح بل المجرمين الخارجين على القانون. .	Language : Arabic ; 	Sentiment : Neutre
Line n 264 : لا مجال للترآجع أمام غطرسة الفسدين وجب تطبيق القانون بصرامة  نشد على أيديكم ونثمن ما تقومون به	Language : Arabic ; 	Sentiment : Positive
Line n 265 : Bravo mr le ministre ,il faut tenir bon,ceux qui refusent le responsable millitaire, cherche à continuer à ne pas travailler et à voler et .....	Language : Other ; 	Sentiment : Unknown
Line n 266 : faut-il au chef du gouvernement de consulter la prochaine fois  ces salauds pour   designer les membres de son gouvernement.ces voyous font tout pour faire régner l anarchie et le désordre pour échapper à tout contrôle ce qui se répercute nécessairement sur la qualité des services rendus par cette institution publique qui paye des salaires (de l'argent du contribuable) pour ces gens qui ne font rien et qui ne sont pas dignes d'être des agents de l'état . FAITES VALOIR L 'ÉTAT DE DROIT Mr. LE MINISTRE quels que soit les dégâts encourus. Tous les tunisiens qui pensent aux intérêts du pays sont avec vous et même passer à la rue pour FAIRE DÉGAGER ces TRAITRES	Language : Other ; 	Sentiment : Unknown
Line n 267 : bravo	Language : Other ; 	Sentiment : Unknown
Line n 268 : bien sure .autrement rien ne passera , tout les citoyens de sfax attendent la réaction de Meur le ministre  qu'elle ne doit pas tarder .,actuellement la majorité du personnel à son  coté que dire des associations,la réplique doit etre tres forte  .il à une bonne occasion pour qu'il démontre son éfficacité et son mérite	Language : Other ; 	Sentiment : Unknown
Line n 269 : Très bien Mr le ministre,vous êtes le Patron	Language : Other ; 	Sentiment : Unknown
Line n 270 : Bravo	Language : Other ; 	Sentiment : Unknown
Line n 271 : Bravo Monsieur kamch khomej ihibou yoktlou laebed moch idawi	Language : Other ; 	Sentiment : Unknown
Line n 272 : bravo	Language : Other ; 	Sentiment : Unknown
Line n 273 : Tenez bon.	Language : Other ; 	Sentiment : Unknown
Line n 274 : Bravoooo	Language : Other ; 	Sentiment : Unknown
Line n 275 : Bravooooo	Language : Other ; 	Sentiment : Unknown
Line n 276 : Bravo	Language : Other ; 	Sentiment : Unknown
Line n 277 : Bravo	Language : Other ; 	Sentiment : Unknown
Line n 278 : WASEL SI 3AIDI BRAVO .AL 9AT3 MA3A AL FASED.	Language : Other ; 	Sentiment : Unknown
Line n 279 : BRAVO.AL 9AT3 MA3A ALFASED.	Language : Other ; 	Sentiment : Unknown
Line n 280 : Bravo	Language : Other ; 	Sentiment : Unknown
Line n 281 : bravooooooooooooooooooooooo	Language : Other ; 	Sentiment : Unknown
Line n 282 : Ena wahda	Language : Other ; 	Sentiment : Unknown
Line n 283 : اجتماع ناجح جداااااا	Language : Tunisian ; 	Sentiment : Neutre
Line n 284 : عندما استمع اليك احس بكل بساطة ان تونس بخير ولا خوف عليها	Language : Tunisian ; 	Sentiment : Positive
Line n 285 : شكرا والف شكر	Language : Arabic ; 	Sentiment : Positive
Line n 286 : نعم للصلح والمصالحة من اجل تونس امنة	Language : Tunisian ; 	Sentiment : Positive
Line n 287 : L'unique lacune dans cette loi de réconciliation est, d'exclure et bouder la transparence. Les instaurateurs de cette loi, ne comprennent-ils pas qu'ainsi, ils  permettent à une mafia de s'enrichir sur leurs dos et ceux des acteurs? Et avec quoi? Avec l'argent public.	Language : Other ; 	Sentiment : Unknown
Line n 288 : Sans transparence, c'est une procédure diabolique, une boucle infinie.	Language : Other ; 	Sentiment : Unknown
Line n 289 : Début	Language : Other ; 	Sentiment : Unknown
Line n 290 :          constante: X	Language : Other ; 	Sentiment : Unknown
Line n 291 :          var: A, B, C, voler, rembourser, réconciliation	Language : Other ; 	Sentiment : Unknown
Line n 292 :   début	Language : Other ; 	Sentiment : Unknown
Line n 293 :          voler := 1million	Language : Other ; 	Sentiment : Unknown
Line n 294 :          rembourser := 100 mille	Language : Other ; 	Sentiment : Unknown
Line n 295 :             début	Language : Other ; 	Sentiment : Unknown
Line n 296 :               A := 1 à X faire	Language : Other ; 	Sentiment : Unknown
Line n 297 :          B :=  voler + 1 million	Language : Other ; 	Sentiment : Unknown
Line n 298 :          C :=  rembourser + 100 mille	Language : Other ; 	Sentiment : Unknown
Line n 299 :                 voler := B	Language : Other ; 	Sentiment : Unknown
Line n 300 :                 rembourser := C	Language : Other ; 	Sentiment : Unknown
Line n 301 :     fin;	Language : Other ; 	Sentiment : Unknown
Line n 302 :         fin;	Language : Other ; 	Sentiment : Unknown
Line n 303 :             fin.	Language : Other ; 	Sentiment : Unknown
Line n 304 : ya mou3arda el fachla dormez vous vous etes 0.t	Language : Other ; 	Sentiment : Unknown
Line n 305 : on devrait te voir plus souvent ds les médias tu as excellé	Language : Other ; 	Sentiment : Unknown
Line n 306 : bravo	Language : Other ; 	Sentiment : Unknown
Line n 307 : ces gens là veulent uniquement dire non !!!!	Language : Other ; 	Sentiment : Unknown
Line n 308 : bravo saida	Language : Other ; 	Sentiment : Unknown
Line n 309 : BRAVO	Language : Other ; 	Sentiment : Unknown
Line n 310 : Intervention claire, nette et précise👍	Language : Other ; 	Sentiment : Unknown
Line n 311 : Bravo	Language : Other ; 	Sentiment : Unknown
Line n 312 : bravo saida klem ma3koul	Language : Other ; 	Sentiment : Unknown
Line n 313 : l'Aid s'annonce bien cette année avec près de 10 milion de moutons	Language : Other ; 	Sentiment : Unknown
Line n 314 : Bravo	Language : Other ; 	Sentiment : Unknown
Line n 315 : Mala MDM sa3ida comme mème	Language : Other ; 	Sentiment : Unknown
Line n 316 : Bien dit	Language : Other ; 	Sentiment : Unknown
Line n 317 : Il faut éclairer les tunisiens ☺	Language : Other ; 	Sentiment : Unknown
Line n 318 : Qui sont contre ce projet? et quels sont leurs arguments? Si c'est productif  le projet peut être amélioré ☺mais le rejeter tout en bloc 😕ça n'a aucun sens 😕les tunisiens sont fatigués des bâtons dans les roues et des politiciens qui parlent sans rien dire😧	Language : Other ; 	Sentiment : Unknown
Line n 319 : b1 fait Hamza pour que les tunisien comprennent ce loi (y)	Language : Other ; 	Sentiment : Unknown
Line n 320 : On est tous d'accord que chacun sait fabriquer le TRI qui convient au mieux à son client. Très bonne journée :)	Language : Other ; 	Sentiment : Unknown
Line n 321 : hkeeyet sabr el aara khedhba w nifak	Language : Other ; 	Sentiment : Unknown
Line n 322 : Eli mayhebech elmosalha  iheb 3lé kharab  tounes  ouhouma  ma3roufine  betbi3a	Language : Other ; 	Sentiment : Unknown
Line n 323 : élli 3andou 7èll è5er iwarrina.yèlli 3morkom mè ta3rfou chnouwa tasyir dawla 5alliwou tounès t9adèm	Language : Other ; 	Sentiment : Unknown
Line n 324 : Dans le site "I watch", le sondage d'opinions sur le projet de loi de réconciliation a donné ce résultat:	Language : Other ; 	Sentiment : Unknown
Line n 325 : - 92% voix contre	Language : Other ; 	Sentiment : Unknown
Line n 326 : - 7% voix pour	Language : Other ; 	Sentiment : Unknown
Line n 327 : - 1% sans réponse	Language : Other ; 	Sentiment : Unknown
Line n 328 : Il y a lieu de rappeler que Hassen Sigma a annoncé que 70% des Tunisiens sont favorables pour le projet d'amnistie.	Language : Other ; 	Sentiment : Unknown
Line n 329 : http://www.babnet.net/mobile/rttdetail.php?id=112146	Language : Arabic ; 	Sentiment : Neutre
Line n 330 : ok mela ay wa7ed 3andou 9aredh m3a elbanka a3mloulou mousal7a	Language : Other ; 	Sentiment : Unknown
Line n 331 : ربي معاك كمشة انتهازيين والله نحشم باش أقول أستاذة	Language : Tunisian ; 	Sentiment : Positive
Line n 332 : شكرا لكم سيدي الوزير على الاقناع....نحن مع نشر ثقافة الانضباط في جميع مكونات المجتمع والشعب معاك	Language : Tunisian ; 	Sentiment : Neutre
Line n 333 : شكرا سيدى الوزير وبما أنكم السباقون لفرض الانضباط و الدفاع على تونس من الانتهازيين فإنني انبهكم أنه في صورة تغلب نقابات التعليم الفاسدة فإن كافة منظومة الدولة ستتبعها و ستعم الفوضى كافة المجتمع لذا فكما يقولون : "الرخ لا"	Language : Tunisian ; 	Sentiment : Neutre
Line n 334 : توة بصراحة لازم الاولياء ياقفوا مع سيد الوزير الي قاعد يعمل من أجل اصلاح التعليم ...فيقوا يا أولياء راهوا الي باش يستنفع هو اولادنا	Language : Tunisian ; 	Sentiment : Negative
Line n 335 : وقتاش تفيقو و اتخذوا	Language : Tunisian ; 	Sentiment : Negative
Line n 336 : 	Language : Arabic ; 	Sentiment : Neutre
Line n 337 : يا اولياء فيقوا و خذوا موقف من المدارس المضربة راهم و لداتنا ضاعوا	Language : Tunisian ; 	Sentiment : Positive
Line n 338 : الفروض الخلاص يقع حسب العمل المقدم لا الشهائد	Language : Arabic ; 	Sentiment : Positive
Line n 339 : شكرا جزيلا لك سيادة الوزير و لك كل الحق فى القرارات التى سيتم تطبيقها إن تواصلت فترة الإضراب	Language : Arabic ; 	Sentiment : Negative
Line n 340 : الله ينصرك  ونحن مع الرجل اللي يخمم في أولادنا مش اللي يخمم في مصلحتو  - معاك حتى النهاية	Language : Tunisian ; 	Sentiment : Negative
Line n 341 : السّؤال الذي حيّر الأولياء : من الصّادق و من الكاذب ؟؟ .. !!	Language : Arabic ; 	Sentiment : Positive
Line n 342 : كان الله في عونك يا سيادة الوزير ،نتمنى ان تفعل هذه القرارات	Language : Tunisian ; 	Sentiment : Neutre
Line n 343 : تو هاذم بشر يارسول الله كمشة انتهازيين لا يجب ان نرضح الي هؤلاء المجرمين الذين يتلاعبون بمصالح اولادنا تفوه علي مايحشمش يا او غاد  ليس الكل كنت لا استطيع ان اتفوه بكلمة الي المعلم ولمن نغسوا فرحة اولادنا الله لا تربحكم	Language : Tunisian ; 	Sentiment : Negative
Line n 344 : الاطار التربوي في تونس مع الاسف قمة الانتهازية	Language : Tunisian ; 	Sentiment : Negative
Line n 345 : وزير خدام و مقنع ربي يوفقه ان شالله....	Language : Tunisian ; 	Sentiment : Positive
Line n 346 : يلزمها سياسي محنك ويعرف كيفاش يخرج من الازمة بأخف الاضرار, وبطبيعة الحال أيام الاضراب تقطع آليا لان الاتحاد هو الذي يمول الاضراب, الناس لايعلمون ذلك على مايبدو؟...لماذا تتحد النقابات ويدفعون مساهمات اذن؟	Language : Tunisian ; 	Sentiment : Neutre
Line n 347 : Bravo Si Jalloul sans oublier les vacances qu'ils bénéficient + 6 mois, les absences, le rendement nul, ...... Le comble c que nous les parents nous les payons directement à travers nos impôts et les études ..... Pour avoir un niveau moyen pour ne pas dire nul 😁😁😁😁	Language : Other ; 	Sentiment : Unknown
Line n 348 : نلخصلكم أنا مشكلة المعلم في تونس: المعلم صارت عندو مشكلة هي في ألأصل عقدة عندها الكثير من التجليات:	Language : Tunisian ; 	Sentiment : Positive
Line n 349 : المعلم ما زال يبكي على أطلال قدر المعلم في الستينات حتى الثمانينات...  و ناسي اللي نحن في القرن 21	Language : Tunisian ; 	Sentiment : Positive
Line n 350 : المعلم اللي في مغلب الحالات و خاصة القيادات النقابية داخلين للتعليم بالباك و يعانو من عقدة النقص أمام ألأساتذة	Language : Tunisian ; 	Sentiment : Positive
Line n 351 : منذ أنتداب متحصلين على ألأستاذية في التعليم ألأبتدائي تفاقمت العقد و صار النقابيون يزايدون في المطالب لتسويتهم بنظرائهم من أساتذة التعليم ألأبتدائي...	Language : Arabic ; 	Sentiment : Negative
Line n 352 : bravo monsieur le ministre je me demande ou sont les parents dans tout ça on doit bouger nous aussi cette année contre nos enfants ne sont pas des jouets entre ses mains UGTT a passer ses limite	Language : Other ; 	Sentiment : Unknown
Line n 353 : اي ترقيات يحبها علي مستوي التلامذا لمهلهل و علي ضهيرهم الميت مساكن اولادنا	Language : Tunisian ; 	Sentiment : Negative
Line n 354 : يحبوها حرب كن انت الاول الذي يعلن الحرب أوقف كاتب العام لنقابة التعليم و الصحة ناس يدخلوا البلاد في حرب  من وراءهم ؟ وانت يا سي العباسي رد بالك تحل فمك تخسر مكانك وانت يا سي الصيد كان ما فيبالكش راهو هالخنار في تونس	Language : Tunisian ; 	Sentiment : Neutre
Line n 355 : الله ينصركم سى ناجى  ازرعوا ثقافة الاضباط  فى البلاد والشعب معاك لان بعض الاشخاص ماحبوش البلاد تريض	Language : Tunisian ; 	Sentiment : Positive
Line n 356 : Allah latraba7hom dhay3ou tlamdha	Language : Other ; 	Sentiment : Unknown
Line n 357 : كل المساندة لوزير التربية ناجي جلول رجل المرحلة بكل المقاييسbravo ,أنا كولى تضررت كثيرا من الإضرابات وفديت من ها الحكاية.	Language : Tunisian ; 	Sentiment : Positive
Line n 358 : ma3lem walah .e5dim 3ala rou7ik w rabi ma3k fi masla7et tunis	Language : Other ; 	Sentiment : Unknown
Line n 359 : wallahi  ana  9a3da  7ayra  min  awlya    ma   t7arkouch    rahi  kartha 7allet  bitlamtha    kolhom  wallaw   thay3in  fi  chwara3  wa  yetkaifou    wi  izatlou   waldihom   ye5edmou    wa  houma  thay3in   wa   hatha  zada   yzid  fi  tadahwer   el   3amel   el  idari    lilwaldin  illi  ye5edmou   wa  moch   metamnin  3la  awladhom	Language : Other ; 	Sentiment : Unknown
Line n 360 : jib  ilbatala  حاسبوهم  علي  الدروس  الخصصية   ثم   ألي  قريو بالساعة  25د	Language : Tunisian ; 	Sentiment : Neutre
Line n 361 : تحصلت تونس اليوم الأربعاء 16 سبتمبر 2015 على المرتبة الأولى بأحسن فيديو ترويجي للسياحة في افريقيا .	Language : Arabic ; 	Sentiment : Negative
Line n 362 : Congratulations to the winners of the first ever UNWTO Tourism Video Competition!	Language : Other ; 	Sentiment : Unknown
Line n 363 : Africa: Tunisia	Language : Other ; 	Sentiment : Unknown
Line n 364 : The Americas: Ecuador	Language : Other ; 	Sentiment : Unknown
Line n 365 : East Asia and the Pacific: Macao (China)	Language : Other ; 	Sentiment : Unknown
Line n 366 : Europe: Hungary	Language : Other ; 	Sentiment : Unknown
Line n 367 : Middle East: Palestine	Language : Other ; 	Sentiment : Unknown
Line n 368 : People's Choice Award: Colombia	Language : Other ; 	Sentiment : Unknown
Line n 369 : bravo monsieur le batonnier il est grand temps de mettre un terme aux  escapades  des partis boudourou  qu on appelle l opposition	Language : Other ; 	Sentiment : Unknown
Line n 370 : bravoooooooooooooooooooooooooo	Language : Other ; 	Sentiment : Unknown
Line n 371 : Il faut que les médias programment des émissions où les experts présentent    l'utilité de cette loi sur le plan socio économique avec des chiffres c'est à dire combien on va gagner en terme de dinars .c'est été mieux si vous avez retardé ceci après les élections municipales pour ne pas laisser l'occasion  aux autres partis de créer des perturbations et profiter  d'elles.	Language : Other ; 	Sentiment : Unknown
Line n 372 : بالتوفيق والنجاح , وإن شاء الله ربي يثبت ويبارك هذه الخطوات.....	Language : Tunisian ; 	Sentiment : Positive
Line n 373 : espoirs et victoire au projet de Nidaa visant la reconstruction de la tunisie pillée et saccagée par nos   "ikhouanes  " criminels .	Language : Other ; 	Sentiment : Unknown
Line n 374 : تفائل كبير و ثقة ثابتة لدا أبناء الجالية ..	Language : Tunisian ; 	Sentiment : Positive
Line n 375 : allah yonsorkom	Language : Other ; 	Sentiment : Unknown
Line n 376 : Mr Sibsi thank you for your patriotism and devotion to the well being of the country	Language : Other ; 	Sentiment : Unknown
Line n 377 : Bajbouj	Language : Other ; 	Sentiment : Unknown
Line n 378 : <3 <3 <3 <3 bajo bouj	Language : Other ; 	Sentiment : Unknown
Line n 379 : Woujouh tfarhed;-)	Language : Other ; 	Sentiment : Unknown
Line n 380 : منتصرون إن شاء الله	Language : Tunisian ; 	Sentiment : Positive
Line n 381 : سننتصر إن شاء الله :*	Language : Tunisian ; 	Sentiment : Positive
Line n 382 : C où ?	Language : Arabic ; 	Sentiment : Neutre
Line n 383 : <3 <3 <3 la victoire est à nous !!!!!!	Language : Other ; 	Sentiment : Unknown
Line n 384 : ya bajbouj echaab maak	Language : Other ; 	Sentiment : Unknown
Line n 385 : malla decoration bravo	Language : Other ; 	Sentiment : Unknown
Line n 386 : الحاصيلوا وهرة النداء وحدهاااااااا	Language : Tunisian ; 	Sentiment : Neutre
Line n 387 : :*	Language : Arabic ; 	Sentiment : Neutre
Line n 388 : Rabi  yonsorna w lem  chemelna  !	Language : Other ; 	Sentiment : Unknown
Line n 389 : choufou elwahra mte3 3arfna ....	Language : Other ; 	Sentiment : Unknown
Line n 390 : Voilà notre belle Tunisie... Embellie par ses hommes et femmes.(les vrais).	Language : Other ; 	Sentiment : Unknown
Line n 391 : On taime bajbouj.	Language : Other ; 	Sentiment : Unknown
Line n 392 : Vive Nida Tounes,Santé et longue vie à son leader!	Language : Other ; 	Sentiment : Unknown
Line n 393 : wahrette el baldya whdha	Language : Other ; 	Sentiment : Unknown
Line n 394 : la merveilleuse TUNISIE sera de retour tres bientot inchallah	Language : Other ; 	Sentiment : Unknown
Line n 395 : <3 ♡ ♥ ♥ ♥ ♥ ♡ vive Nida	Language : Other ; 	Sentiment : Unknown
Line n 396 : Rabbi tawel fi omrek ya bajbouj	Language : Other ; 	Sentiment : Unknown
Line n 397 : وينو بن علي هاو موش موجود يا كلاب	Language : Tunisian ; 	Sentiment : Negative
Line n 398 : Bajbouj ya ma3llem	Language : Other ; 	Sentiment : Unknown
Line n 399 : Des tunisiens ... des vrais !+	Language : Other ; 	Sentiment : Unknown
Line n 400 : <3 <3 <3 Marbouha nchallah !	Language : Other ; 	Sentiment : Unknown
Line n 401 : <3	Language : Other ; 	Sentiment : Unknown
Line n 402 : bravooooo si mohsen	Language : Other ; 	Sentiment : Unknown
Line n 403 : رغم الداء والاعداء ستبقى تونس الخضراء علمها يرفرف عاليا في السماء	Language : Tunisian ; 	Sentiment : Neutre
Line n 404 : Nchallah terja3 tounes  el jemila	Language : Other ; 	Sentiment : Unknown
Line n 405 : بسم الله الرحمٰن الرحيم	Language : Tunisian ; 	Sentiment : Neutre
Line n 406 : ﴿هُوَ الَّذِي أَنزَلَ مِنَ السَّمَاء مَاء لَّكُم مِّنْهُ شَرَابٌ وَمِنْهُ شَجَرٌ فِيهِ تُسِيمُونَ {10} يُنبِتُ لَكُم بِهِ الزَّرْعَ وَالزَّيْتُونَ وَالنَّخِيلَ وَالأَعْنَابَ وَمِن كُلِّ الثَّمَرَاتِ إِنَّ فِي ذَلِكَ لآيَةً لِّقَوْمٍ يَتَفَكَّرُونَ {11}	Language : Tunisian ; 	Sentiment : Positive
Line n 407 : صدق الله العظيم	Language : Arabic ; 	Sentiment : Neutre
Line n 408 : سورة النحل (الآيات: 10و 11 )	Language : Arabic ; 	Sentiment : Positive
Line n 409 : Ya baladi	Language : Other ; 	Sentiment : Unknown
Line n 410 : الحق حق والباطل باطل :النخلة هى أصلا شعار المؤمن الصادق لأن النخلة تصمد أمام الرياح القوية لا تميل ولا تتلوى بل هى دوما ثابتة..وأما الحمامة فهى تطير يمينا ويسارا , شرقا ,غربا لا تستقر على حال.	Language : Arabic ; 	Sentiment : Neutre
Line n 411 : ennida monkedh lebled	Language : Other ; 	Sentiment : Unknown
Line n 412 : ya rabi yonsrou w yonsor nidaa tounès w tounès w nit5alsou min a3de2 tounès	Language : Other ; 	Sentiment : Unknown
Line n 413 : Il mène le combat comme un jeune ; que Dieu le protège .Vive la Tunisie.	Language : Other ; 	Sentiment : Unknown
Line n 414 : Tunisiens ; il est tps de bouger ; de sensibiliser les gens : le pays est en danger; l'avenir est catastrophique si on ne participe pas à la libération de la Tunisie	Language : Other ; 	Sentiment : Unknown
Line n 415 : <3 <3 <3	Language : Other ; 	Sentiment : Unknown
Line n 416 : rabi yi tawel fi 3omrou si el beji w yehmih	Language : Other ; 	Sentiment : Unknown
Line n 417 : ahla bajbouj	Language : Other ; 	Sentiment : Unknown
Line n 418 : bajbouj <3	Language : Other ; 	Sentiment : Unknown
Line n 419 : Tsawer elli bkaw el barra tahiya lihom	Language : Other ; 	Sentiment : Unknown
Line n 420 : AHHHHHHHHHHHHHHHHH FAKERNA B BOUNA EL 3ZIZ BOURGUIBA	Language : Other ; 	Sentiment : Unknown
Line n 421 : 😍bravo	Language : Other ; 	Sentiment : Unknown
Line n 422 : منتصرون انشاالله.. تحيا تونس ولا عاش من خانها	Language : Tunisian ; 	Sentiment : Negative
Line n 423 : روعة لحمي قشعر والله <3	Language : Tunisian ; 	Sentiment : Neutre
Line n 424 : منتصرون إن شاء الله	Language : Tunisian ; 	Sentiment : Positive
Line n 425 : ya bajbouj ya mhaf	Language : Other ; 	Sentiment : Unknown
Line n 426 : http://www.youtube.com/watch?v=pU8ZUpBIJDo	Language : Arabic ; 	Sentiment : Neutre
Line n 427 : Bjbouj ya m3alem	Language : Other ; 	Sentiment : Unknown
Line n 428 : وقتاه فى حمامات؟	Language : Arabic ; 	Sentiment : Neutre
Line n 429 : (y)	Language : Other ; 	Sentiment : Unknown
Line n 430 : المشكل ليس في السيد الباجي بل في الذين من حوله و المشرفين عن الحملات و التظهرات و الانشطة الرسمية وغيرها ......انهم لا يحملون نفس الفكر البورقيبي	Language : Arabic ; 	Sentiment : Negative
Line n 431 : Votez Utile ! Votez Intelligent !! Votez Nida !!!	Language : Other ; 	Sentiment : Unknown
Line n 432 : عودة الرّوح الى تونس	Language : Arabic ; 	Sentiment : Neutre
Line n 433 : Bravo et mille bravo pour Nidaa tounes ...	Language : Other ; 	Sentiment : Unknown
Line n 434 : tout ce que ns souhaitons c'est la cohésion totale du peuple tunisien en entier pour que le pays réussisse dans sa révolution  et dans le processus démocratique .....il faut réunir pour réussir ...il ne faut tomber dans le piège .	Language : Other ; 	Sentiment : Unknown
Line n 435 : ennida monkedh lebled	Language : Other ; 	Sentiment : Unknown
Line n 436 : ya rabi yonsrou w yonsor nidaa tounès w tounès w nit5alsou min a3de2 tounès	Language : Other ; 	Sentiment : Unknown
Line n 437 : Il mène le combat comme un jeune ; que Dieu le protège .Vive la Tunisie.	Language : Other ; 	Sentiment : Unknown
Line n 438 : Tunisiens ; il est tps de bouger ; de sensibiliser les gens : le pays est en danger; l'avenir est catastrophique si on ne participe pas à la libération de la Tunisie	Language : Other ; 	Sentiment : Unknown
Line n 439 : <3 <3 <3	Language : Other ; 	Sentiment : Unknown
Line n 440 : rabi yi tawel fi 3omrou si el beji w yehmih	Language : Other ; 	Sentiment : Unknown
Line n 441 : ahla bajbouj	Language : Other ; 	Sentiment : Unknown
Line n 442 : bajbouj <3	Language : Other ; 	Sentiment : Unknown
Line n 443 : Tsawer elli bkaw el barra tahiya lihom	Language : Other ; 	Sentiment : Unknown
Line n 444 : AHHHHHHHHHHHHHHHHH FAKERNA B BOUNA EL 3ZIZ BOURGUIBA	Language : Other ; 	Sentiment : Unknown
Line n 445 : 😍bravo	Language : Other ; 	Sentiment : Unknown
Line n 446 : منتصرون انشاالله.. تحيا تونس ولا عاش من خانها	Language : Tunisian ; 	Sentiment : Negative
Line n 447 : روعة لحمي قشعر والله <3	Language : Tunisian ; 	Sentiment : Neutre
Line n 448 : منتصرون إن شاء الله	Language : Tunisian ; 	Sentiment : Positive
Line n 449 : ya bajbouj ya mhaf	Language : Other ; 	Sentiment : Unknown
Line n 450 : http://www.youtube.com/watch?v=pU8ZUpBIJDo	Language : Arabic ; 	Sentiment : Neutre
Line n 451 : Bjbouj ya m3alem	Language : Other ; 	Sentiment : Unknown
Line n 452 : وقتاه فى حمامات؟	Language : Arabic ; 	Sentiment : Neutre
Line n 453 : (y)	Language : Other ; 	Sentiment : Unknown
Line n 454 : المشكل ليس في السيد الباجي بل في الذين من حوله و المشرفين عن الحملات و التظهرات و الانشطة الرسمية وغيرها ......انهم لا يحملون نفس الفكر البورقيبي	Language : Arabic ; 	Sentiment : Negative
Line n 455 : Votez Utile ! Votez Intelligent !! Votez Nida !!!	Language : Other ; 	Sentiment : Unknown
Line n 456 : عودة الرّوح الى تونس	Language : Arabic ; 	Sentiment : Neutre
Line n 457 : Bravo et mille bravo pour Nidaa tounes ...	Language : Other ; 	Sentiment : Unknown
Line n 458 : tout ce que ns souhaitons c'est la cohésion totale du peuple tunisien en entier pour que le pays réussisse dans sa révolution  et dans le processus démocratique .....il faut réunir pour réussir ...il ne faut tomber dans le piège .	Language : Other ; 	Sentiment : Unknown
Line n 459 : بجبوج يا معذبهم ♥	Language : Tunisian ; 	Sentiment : Positive
Line n 460 : Bajbouj yè ghali .	Language : Other ; 	Sentiment : Unknown
Line n 461 : Echa3b ma3k ya bajbouj	Language : Other ; 	Sentiment : Unknown
Line n 462 : تونسي تونسي و توانسة كيف يشوفوه و جو تونسي زايد محلاها تونس هكا . كان فيك الخير ربي يكتبك لهالبلاد المنكوبة امين.	Language : Tunisian ; 	Sentiment : Positive
Line n 463 : bajbouj ya m3alemm nchallah betawfikk	Language : Other ; 	Sentiment : Unknown
Line n 464 : Rabbi yahfthek ye bajboujna	Language : Other ; 	Sentiment : Unknown
Line n 465 : Hakeka tjiibha ya bejbouj	Language : Other ; 	Sentiment : Unknown
Line n 466 : محكوم عليك يا ولدي ان تنجح وان لا تركع  , وتونس الخضراء تناديك اغثني اغثني يا شعبي  يا اعز ابنائي ...يا وطني العزيز ...	Language : Tunisian ; 	Sentiment : Positive
Line n 467 : Barra toll 3la silyana	Language : Other ; 	Sentiment : Unknown
Line n 468 : معشوق الجماهير ربي يطول في عمرو	Language : Tunisian ; 	Sentiment : Neutre
Line n 469 : BRAVO	Language : Other ; 	Sentiment : Unknown
Line n 470 : iaaa berjouli bajbouj howa el kol wlh <3 :*	Language : Other ; 	Sentiment : Unknown
Line n 471 : السياحة مشات يا بجبوج :(	Language : Tunisian ; 	Sentiment : Neutre
Line n 472 : باقة ورد عربون ود ومحبة من اهالي مدينة الحمامات الاحرار مساندي سي الباجي والنداء	Language : Arabic ; 	Sentiment : Neutre
Line n 473 : Barra toll 3la silyana ma faha bes rahou	Language : Other ; 	Sentiment : Unknown
Line n 474 : bajbouj il bouje machallah 3lik	Language : Other ; 	Sentiment : Unknown
Line n 475 : ♡	Language : Arabic ; 	Sentiment : Neutre
Line n 476 : قاهر الاخوان وقطيع الخرفان، بجبوج يا معذبهم !	Language : Tunisian ; 	Sentiment : Positive
Line n 477 : Imed Fedhila	Language : Other ; 	Sentiment : Unknown
Line n 478 : Imed Fedhila ;)	Language : Other ; 	Sentiment : Unknown
Line n 479 : <3	Language : Other ; 	Sentiment : Unknown
Line n 480 : Le grand reste toujours grand	Language : Other ; 	Sentiment : Unknown
Line n 481 : LA CLASSE COMME TOUJOURS :)	Language : Other ; 	Sentiment : Unknown
Line n 482 : el7out a3lik y bjbouj	Language : Other ; 	Sentiment : Unknown
Line n 483 : enfin un peuple	Language : Other ; 	Sentiment : Unknown
Line n 484 : نعم تحيا تونس وتحيا حركة نداء تونس ورئيسها الاستاذ الباجي القائد السبسي ويحيا شباب وشابات تونس حماة الوطن وعمادتها في المستقبل لان صون تونسنا العزيزة واستمرارية الدولة فيها ترتكز وبقوة على شباتها وشبانها الذين يذودون عنها بالروح وبالدم ويكونون سدا منيعا على كل من يريد العبث بامنها وسيادتها والحد من تقدمها وضد من يريدون العبث بامنها وحرية وكرامة التونسيين امثال ها حركة النكبة الخوانجية ومن والاها..ولذا يا شباب وياشابات تونس ويا احرار وحراير تونس كونوا في الموعد وعن بكرة ابيكم في يوم الحسم يوم الانتخابات القادمة لنصرة تونس ونصرة نداء تونس ورئيسها الاستاذ الباجي قائد السبسي للقطع والى الابد الطريق عن الارهاب والارهابيين ولينعم التونسيين في تونسنا الحبيبة بالامن والامان..النصر لتونس والنصر لحركة نداء تونس والنصر المضفر لشابات وشبان تونس ان شاء لله.... ميموني	Language : Tunisian ; 	Sentiment : Positive
Line n 485 : Chay ikbir	Language : Other ; 	Sentiment : Unknown
Line n 486 : هكاكة يا بجبج يا قاهر الجردان	Language : Tunisian ; 	Sentiment : Negative
Line n 487 : rabbi yahmi tuness...	Language : Other ; 	Sentiment : Unknown
Line n 488 : Je rêve d'une grande fête le soir du 26 octobre ....ya rabbi matkhayebnech ...!!!!	Language : Other ; 	Sentiment : Unknown
Line n 489 : rabi itwal fi 3omrak a la grande	Language : Other ; 	Sentiment : Unknown
Line n 490 : el baji lem3allem 9aher el jerthan le5wanjia	Language : Other ; 	Sentiment : Unknown
Line n 491 : يا ربي تحميه و تحمي تونس و تحيا تونس حرّة مستقلّة أبد الدهر	Language : Tunisian ; 	Sentiment : Neutre
Line n 492 : Ce qui est bizarre dans les commentaire, ceux qui veulent critiquer nida ont un niveau bas argumentation nul et impolit donc par experience on doit les reconnaitre, des traitres et pour un chocotom vendent leurs patrie	Language : Other ; 	Sentiment : Unknown
Line n 493 : Hereusement qu'ils sont minoritaire	Language : Other ; 	Sentiment : Unknown
Line n 494 : Je leurs dis soyez prudent l'argent sale ne fait jamais le bonheure voyez vos commanditaires	Language : Other ; 	Sentiment : Unknown
Line n 495 : Ils n'ont pas pour  longtemps!	Language : Other ; 	Sentiment : Unknown
Line n 496 : مايتحلش الفيديو وال كلاام الغير لاايق لم يكن من شهم الكرام انا ارا الحملة منقوصة وهناك تقصير من رايس الحملة امام ما تقدمه النهضة وتواجد مكاتبها في كال الااحيا والاازقة والارياف مدير الحملة واتق اكتر من الاازم وهاذا غلط النجاح يتكامل لما نقرا حساب لي الصغيرو والاا الكبيرة اردو بالنا مصير تونس في الميزان ماتنفعناش الراسة بدون برلمان لاان الراسة صلااحياتهامحدودة وهاذا ما وصلت له النهضة يجب التكيز اكتر علي القوام المترشحة لمجلس التاسيسي وهو المهم ولم نسمع احد منهم راساالقواام يقومون بزيارات مبرمجة تذكروني في السياسة الحصول علي كرسي ولم يكون لهم اتر يذكر انهم محيطين بزوملي اهم رجال الاعمال والحاشية المقربة ويمرون  ويسلمون علي الشباب ويتهي الموكب باشتماع مغلوق وبعدها يخرج ليستمع االتصفيق وبعض الشعارات هاذا في صفاقس اناخايف انهضو باندا في كل مكان لاا للمركزية ارد الانتما وانتميت لاكن لم يعطوني بطاقة الاانتما لانها تعطا كان في العاصمة تونس انا اكتب هاذا الكلاام غيرة علي تونس ولالفات النضر تحيا تونس ورايسها من حزب الندا سي الباجي حفضه الله هذا رايي وانا حر فيه واحترم من يخالفني	Language : Tunisian ; 	Sentiment : Negative
Line n 497 : bravo bravo	Language : Other ; 	Sentiment : Unknown
